10
10
15,15,15,15,15,15,15,15,15,15,
9,6,6,6,6,6,6,6,6,9,
10,15,15,15,15,15,15,15,15,8,
10,15,15,15,15,15,15,15,15,8,
10,15,15,15,15,15,15,15,15,8,
10,15,15,15,15,15,15,15,15,8,
10,15,15,15,15,15,15,15,15,8,
10,15,15,15,15,15,15,15,15,8,
10,15,15,15,15,15,15,15,15,8,
4,1,1,1,1,1,1,1,1,3,
